******E**
* *  * **
*   *   *
*** * ***
*       *
* *** * *
* * * * *
*S*     *
*********